S..#..#.#.###
#....#..#...#
E#.#...#..###
.#..#.#..#..#
..#.#..#.##.#
#.#...#.....#
...#.####.###
.#...##.#..##
.#........#..
...##.##....#
#####.##.##.#