.S.#...#...#....#
#.#..#...#...#..#
#...###..#.#.#.##
..#..###...###..#
#..#.....#.....##
##...##.#..###...
##E...###.#####.#
###..#..........#
#############..##
.................