........#...
##.....#...#
......#.#...
.#.....#.#.#
.#.#......#S
...#...#....
.#...#.#...#
.#.#..E.....
.#.#.#.#....
.#..#.#....#
....#......#