.....#.#...#.....#
#.#....#.#...#....
....#..........#..
###.#######S...#..
.#...........#...#
...####.#######.##
.#.....#..........
#..#.....#.E##..#.
..#....#...#......
#....#.......#.##.