.S#..##..#.##.##
.#......#..##.#.
..#.##.##.###...
.#...#..#.#.#..#
..#.#..#....##.#
#.##.....##....#
#....###.###.###
####.........###
#####.#####.####
##E.#...#.....##
###.#.#.##.#.#.#
#...#.#....###.#
#.###.##.#.....#
#........#######