S......#....
..####.##...
#....#....##
E###...#...#
.##..#.#..#.
.##..#.#..#.
.##..#.#..#.
....#..#....
.##......#..