..S###...#
.#.....###
.#.##....#
..#...##.#
..###.##.#
......##.#
###.####.#
....####.#
##...#...#
###....#E#
....##...#