.#..#..#...#
##.#.#.#...#
....#.#.E...
.#.....#.#.#
.#.#......##
...#...#..#.
.S...#.#...#
.#.#.....#..
.#.#.#.#....
....#.#....#
.#..#.....##