#....#S....
..#...#.##.
#..#.#####.
#..##...##.
##....#....
...E#...#.#
##...##...#