..#..#..#...
##.#.#.#...#
....#.#.#...
.#.S...#.#.#
.#.#..#....#
...#...#..#.
.....#.#...#
.#.......#..
.#.#.#.#....
....#.#....#
....E...#..#