S.#..#.#E..
#..#...#.#.
##...##..#.
#..#.###...
##.#..#..##
....#...#..
..#..#....#