##S.#..#...#
...#.......#
#.##.#####.#
.....#####.#
#.##.......#
#....###.###
...#..#....#
..#..#.....#
...#...#.#.#
.#.####....#
E#......####
...####.####
#######.####