.....#..#...
##.#.#.#.S.#
....#.#.#...
.#.....#.#.#
.#.#..,...##
...#...#..#.
.#...#.#...#
.#.#........
.#.#.#.#....
.E..#.#....#
..........##