S....#..#...
##.#.#.#...#
....#.#.#...
.#.....#.#.#
.#.#..E...##
...#...#..#.
.#...#.#...#
.#.#........
.#.#.#.#....
....#.#....#
..........##