##S..................#
#######....###########
..#...#..#..#..#...#.#
....#.#.....#.#...#.#.
#E#.####......#.#.....
###.....###.......##..
....#.#......#.###....